map

       10 11
   9 ⬜ ⬜ ⬜ ⬜ 0
   8 ⬜ ⬜ ⬜ ⬜ 1
   7 ⬜ ⬜ ⬜ ⬜ 2
     ⬜ ⬜ ⬜ ⬜ 3
     6  5 4

     0 = [0,3]
     1 = [1,3]
     2 = [2,3]
     3 = [3,3]
     4 = [3,2]
     5 = [3,1]
     6 = [3,0]
     7 = [2,0]
     8 = [1,0]
     9 = [0,0]
     10 = [0,1]
     11 = [0,2]

